################################
#..............................#
#..#...............#####.......#
#.###....#.........#...#.......#
#..#.....#.........#...#.......#
#......###.........#####.......#
#..............................#
########################.#######
                       #.#
                      #....#
                      #....#
                      #..#.#
                      ######